R 1920 1080
NO ./img/eagle.xpm
SO ./img/greystone.xpm
WE ./img/purplestone.xpm
EA ./img/wood.xpm         

S ./img/greenlight.xpm
F 220,100,0
C 255,255,255





        1111111111111111111111111
        1000000000110000000000001
        1011000001110000002000001
        1001000000000000000000001
111111111011000001110000000000001
100000000011000001110111111111111
11110111111111011100000010001
11110111111111011101010000001
11000000110101011100000010001
10002000000000001100000010001
10000000000000001101010010001
11000001110101011111011110N0111
11110111 1110101 001111010001
11111111 1111111 111111111111