EA ./img/wood.xpm         
NO ./img/eagle.xpm
SO ./img/greystone.xpm
F 220,100,0 
WE ./img/purplestone.xpm
S ./img/barrel.xpm
R  1000  750 
C 25 5,   2  5  5,   2  55
        1111111111111111111111111
        1         11            1
        1 11     111            1
        1  1                    1
111111111 11     111            1
1         11     111 111111111111
1111 111111111 111          1
1111      1111 111 1 1  1   1
11111 111111111111      1   1
1                       1   1
1       22222    11 1 1  1  1
1       22222   211 1 1  1  1
1 22W   22222    11 1 1  1  1
1       22222    11 1 1  1  1
1       22222    11 1 1  1  1
1                11 1 1  1  1
1                11 1 1  1  1
1                   1 1  1  1
11 111111111111111111 1 11  111
11 1     111 1 1   1111 1   1
1  1  1                     1
1     11 1111111 111111111111
11111111111111111111111111111